AnkiDroid Flashcards
ar: البطاقات التعليميةآنكيدرويد
bg: AnkiDroid Флашкарти
ca: AnkiDroid fitxes per memoritzar
cs: AnkiDroid kartičky
de: AnkiDroid Karteikarten
el: Κάρτες Ανκί-Ντρόιντ
eo: AnkiDroid
es-AR: Tarjetas flash AnkiDroid
es-ES: Tarjetas AnkiDroid
et: AnkiDroid mälukaardid
fa: فلش کارتهای انکی دروید
fi: AnkiDroid-muistikortit
fr: AnkiDroid (Cartes mémoire)
gl: Cartóns AnkiDroid
he: AnkiDroid כרטיסי לימוד
hi: AnkiDroid फ़्लैशकार्ड
hu: AnkiDroid Szókártyák
id: Kad imbas AnkiDroid
ko: AnkiDroid 플래시 카드
lt: „AnkiDroid“ atminties kortelės
nl: AnkiDroid flitskaarten
pl: AnkiDroid – Fiszki
ru: AnkiDroid: карточки для запоминания
sk: AnkiDroid kartičky
sl: Pomnilne kartice AnkiDroid 
sr: AnkiDroid флеш-картице
sv-SE: AnkiDroid Flashkort
th: บัตรคำ AnkiDroid
tr: AnkiDroid Bilgi Kartları
vi: Thẻ thông minh AnkiDroid
zh-CN: AnkiDroid 记忆卡片
zh-TW: AnkiDroid 抽認卡